"a" = (/mob/NPC/Shopkeeper,/turf/carpet,/area)
"b" = (/turf/stone,/area)
"c" = (/turf/carpet,/area)
"d" = (/obj,/turf/carpet,/area)
"e" = (/turf/tree,/area)
"f" = (/turf/sidewalk,/area)
"g" = (/turf/grass,/area)
"h" = (/turf/house,/area)
"i" = (/mob/NPC/The_Thing,/turf/carpet,/area)

(1,1,1) = {"
gggggggggggggggggggggggggggggggggggggggg
gggggggggggggggggggggggggggggggggggggggg
gggggggggggggggggggffggffggggggggggggggg
ggggggggggggggggggffffffffgggggggggggggg
gggggggggggggggggffffffffffggggggggggggg
ggggggggggggggggggffffffffgggggggggggggg
gggggggggggggggggggffffffggggggggggggggg
ggggggggggggggggggggffffgggggggggggggggg
gggggggggggggggggggggffggggggggggggggggg
gggggggggggggggggggggbbggggggggggggggggg
gggggggggggggggggggggffggggggggggggggggg
gggggggggggggggggggggffggggggggggggggggg
eeeeeeeeeeeggggggggggffggggggggggggggggg
eeeeeeeeeeeggggggggggffggeeeeeeeeeeeeeee
eeeeeeeeeeeggggggggggffggeeeeeeeeeeeeeee
eeeeeeeeeeeggggggggggffggeeeeeeeeeeeeeee
gggggggggggggggggggggffggggggggggggggggg
hhhhhhhggggggggggggggffggggggggggggggggg
hhhhhhhfffffggggggggfffggggggggggggggggg
hhhhhhhffffffggggggffffggggggggggggggggg
hhhhhhhggggfffffffffffffgggggggggggggggg
ggggggggggggfffffffffffffggggggggggggggg
ggggggggggggggggggggggffffffffffgggggggg
ggggggeeeeeeeeeeeeeeeegffffffffffggggggg
gggggebbbbbbbbbbbbbbbbeggggggggfffgggggg
gggggebccccccccccccccbegggggggggfffggggg
gggggebcccdcccccbaabcbeggggggggggffggggg
gggggebcccccccccbbbbcbeggggggggggffggggg
gggggebccccccccccccccbeggggggggggffggggg
gggggebccccccicccccccbeggggggggggffggggg
gggggebccccccccccccccbebggbggggggffggggg
gggggebccccccccccccccbegbbgggggggffggggg
gggggebbbbbbccbbbbbbbbegffgggggggffggggg
ggggggeeeeeeffeeeeeeeeggffgggggggffggggg
ggggggggggggffgggggggggfffgggggggffggggg
ggggggggggggffggggggggfffggggggggffggggg
ggggggggggggfffeeeeeeeffeeeeeeeefffggggg
gggggggggggggfffffffffffffffffffffgggggg
ggggggggggggggffffffffggfffffffffggggggg
gggggggggggggggggggggggggggggggggggggggg
"}
