"a" = (/mob/NPC/Shopkeeper,/turf/sidewalk,/area)
"b" = (/turf/stone,/area)
"c" = (/turf/carpet,/area)
"d" = (/obj,/turf/carpet,/area)
"e" = (/turf/tree,/area)
"f" = (/turf/sidewalk,/area)
"g" = (/turf/grass,/area)

(1,1,1) = {"
gggggggggggggggggggggggggggggggggggggggg
gggggggggggggggggggggggggggggggggggggggg
gggggggggggggggggggggggggggggggggggggggg
gggggggggggggggggggggggggggggggggggggggg
gggggggggggggggggggggggggggggggggggggggg
gggggggggggggggggggggggggggggggggggggggg
gggggggggggggggggggggggggggggggggggggggg
gggggggggggggggggggggggggggggggggggggggg
gggggggggggggggggggggggggggggggggggggggg
gggggggggggggggggggggggggggggggggggggggg
gggggggggggggggggggggggggggggggggggggggg
gggggggggggggggggggggggggggggggggggggggg
gggggggggggggggggggggggggggggggggggggggg
gggggggggggggggggggggggggggggggggggggggg
gggggggggggggggggggggggggggggggggggggggg
gggggggggggggggggggggggggggggggggggggggg
gggggggggggggggggggggggggggggggggggggggg
gggggggggggggggggggggggggggggggggggggggg
gggggggggggggggggggggggggggggggggggggggg
gggggggggggggggggggggggggggggggggggggggg
gggggggggggggggggggggggggggggggggggggggg
gggggggggggggggggggggggggggggggggggggggg
gggggggggggggggggggggggggggggggggggggggg
ggggggeeeeeeeeeeeeeeeegggggggggggggggggg
gggggebbbbbbbbbbbbbbbbeggggggggggggggggg
gggggebccccccccccccccbeggggggggggggggggg
gggggebcccdccccccccccbeggggggggggffggggg
gggggebccccccccccccccbeggggggggggffggggg
gggggebccccccccccccccbeggggggggggffggggg
gggggebccccccccccccccbeggggggggggffggggg
gggggebccccccccccccccbebggbggggggffggggg
gggggebccccccccccccccbegbbgggggggffggggg
gggggebbbbbbccbbbbbbbbegaagggggggffggggg
ggggggeeeeeeffeeeeeeeeggffgggggggffggggg
ggggggggggggffgggggggggfffgggggggffggggg
ggggggggggggffggggggggfffggggggggffggggg
ggggggggggggfffeeeeeeeffeeeeeeeefffggggg
gggggggggggggfffffffffffffffffffffgggggg
ggggggggggggggffffffffggfffffffffggggggg
gggggggggggggggggggggggggggggggggggggggg
"}
